S...................................................................................................
..#....#..............#........#..............#..............#..............#..............#........
..............#..............#..............#..............#..............#..............#..........
....#..............#..............#..............#..............#..............#..............#.....
..............#..............#..............#..............#..............#..............#..........
........#..............#..............#..............#..............#..............#................
..............#..............#..............#..............#..............#..............#..........
....#..............#..............#..............#..............#..............#..............#.....
..............#..............#..............#..............#..............#..............#..........
........#..............#..............#..............#..............#..............#................
..............#..............#..............#..............#..............#..............#..........
....#..............#..............#..............#..............#..............#..............#.....
..............#..............#..............#..............#..............#..............#..........
........#..............#..............#..............#..............#..............#................
..............#..............#..............#..............#..............#..............#..........
....#..............#..............#..............#..............#..............#..............#.....
..............#..............#..............#..............#..............#..............#..........
........#..............#..............#..............#..............#..............#................
..............#..............#..............#..............#..............#..............#..........
....#..............#..............#..............#..............#..............#..............#.....
..............#..............#..............#..............#..............#..............#..........
....#..............#..............#..............#..............#..............#..............#.....
..............#..............#..............#..............#..............#..............#..........
........#..............#..............#..............#..............#..............#................
..............#..............#..............#..............#..............#..............#..........
....#..............#..............#..............#..............#..............#..............#.....
..............#..............#..............#..............#..............#..............#..........
........#..............#..............#..............#..............#..............#................
..............#..............#..............#..............#..............#..............#..........
....#..............#..............#..............#..............#..............#..............#.....
..............#..............#..............#..............#..............#..............#..........
........#..............#..............#..............#..............#..............#................
..............#..............#..............#..............#..............#..............#..........
....#..............#..............#..............#..............#..............#..............#.....
..............#..............#..............#..............#..............#..............#..........
........#..............#..............#..............#..............#..............#................
..............#..............#..............#..............#..............#..............#..........
....#..............#..............#..............#..............#..............#..............#.....
..............#..............#..............#..............#..............#..............#..........
........#..............#..............#..............#..............#..............#................
..............#..............#..............#..............#..............#..............#..........
....#..............#..............#..............#..............#..............#..............#.....
..............#..............#..............#..............#..............#..............#..........
........#..............#..............#..............#..............#..............#................
..............#..............#..............#..............#..............#..............#..........
....#..............#..............#..............#..............#..............#..............#.....
..............#..............#..............#..............#..............#..............#..........
........#..............#..............#..............#..............#..............#................
..............#..............#..............#..............#..............#..............#..........
....#..............#..............#..............#..............#..............#..............#.....
..............#..............#..............#..............#..............#..............#..........
........#..............#..............#..............#..............#..............#................
..............#..............#..............#..............#..............#..............#..........
....#..............#..............#..............#..............#..............#..............#.....
..............#..............#..............#..............#..............#..............#..........
........#..............#..............#..............#..............#..............#................
..............#..............#..............#..............#..............#..............#..........
....#..............#..............#..............#..............#..............#..............#.....
..............#..............#..............#..............#..............#..............#..........
........#..............#..............#..............#..............#..............#................
..............#..............#..............#..............#..............#..............#..........
....#..............#..............#..............#..............#..............#..............#.....
..............#..............#..............#..............#..............#..............#..........
........#..............#..............#..............#..............#..............#................
..............#..............#..............#..............#..............#..............#..........
....#..............#..............#..............#..............#..............#..............#.....
..............#..............#..............#..............#..............#..............#..........
........#..............#..............#..............#..............#..............#................
..............#..............#..............#..............#..............#..............#..........
....#..............#..............#..............#..............#..............#..............#.....
..............#..............#..............#..............#..............#..............#..........
........#..............#..............#..............#..............#..............#................
..............#..............#..............#..............#..............#..............#..........
....#..............#..............#..............#..............#..............#..............#.....
..............#..............#..............#..............#..............#..............#..........
........#..............#..............#..............#..............#..............#................
..............#..............#..............#..............#..............#..............#..........
....#..............#..............#..............#..............#..............#..............#.....
..............#..............#..............#..............#..............#..............#..........
........#..............#..............#..............#..............#..............#................
..............#..............#..............#..............#..............#..............#..........
....#..............#..............#..............#..............#..............#..............#.....
..............#..............#..............#..............#..............#..............#..........
........#..............#..............#..............#..............#..............#................
..............#..............#..............#..............#..............#..............#..........
....#..............#..............#..............#..............#..............#..............#.....
..............#..............#..............#..............#..............#..............#..........
........#..............#..............#..............#..............#..............#................
..............#..............#..............#..............#..............#..............#..........
....#..............#..............#..............#..............#..............#..............#.....
..............#..............#..............#..............#..............#..............#..........
........#..............#..............#..............#..............#..............#................
..............#..............#..............#..............#..............#..............#..........
....#..............#..............#..............#..............#..............#..............#.....
..............#..............#..............#..............#..............#..............#..........
........#..............#..............#..............#..............#..............#................
..............#..............#..............#..............#..............#..............#..........
....#..............#..............#..............#..............#..............#..............#.....
..............#..............#..............#..............#..............#..............#.......###
.................................................................................................#E.